{
    "map": [
        [1, 1, 1, 1, 1, 1, 1, 1, 1],
        [1, 0, 0, 0, 0, 0, 0, 4, 1],
        [1, 1, 1, 1, 0, 1, 0, 1, 1],
        [1, 0, 0, 0, 0, 0, 0, 0, 1],
        [1, 1, 0, 1, 2, 1, 1, 0, 1],
        [1, 0, 0, 0, 2, 0, 0, 0, 1],
        [1, 0, 0, 0, 1, 0, 0, 0, 1],
        [1, 0, 0, 0, 1, 4, 0, 0, 1],
        [1, 1, 1, 1, 1, 1, 1, 1, 1]
    ],
    "agent_start_position": [1, 2],
    "agent_start_size": 1,
    "boxes_start_positions": [
        [2, 6],
        [6, 3]
    ],
    "movements_limit": 36
}
