{
    "map": [
        [1, 1, 1, 1, 1, 1, 1, 1, 1],
        [1, 0, 0, 1, 0, 0, 2, 0, 1],
        [1, 0, 0, 1, 0, 4, 0, 0, 1],
        [1, 0, 4, 0, 0, 0, 0, 3, 1],
        [1, 1, 1, 1, 0, 1, 0, 1, 1],
        [1, 0, 0, 0, 0, 0, 4, 0, 1],
        [1, 0, 0, 4, 0, 0, 0, 0, 1],
        [1, 0, 0, 0, 0, 0, 0, 0, 1],
        [1, 1, 1, 1, 1, 1, 1, 1, 1]
    ],
    "agent_start_position": [1, 1],
    "agent_start_size": 2,
    "boxes_start_positions": [
        [4, 4]
    ],
    "movements_limit": 19
}