{
    "map": [
        [1, 1, 1, 1, 1, 1, 1, 1, 1],
        [1, 0, 0, 0, 1, 0, 0, 4, 1],
        [1, 0, 4, 0, 1, 0, 0, 0, 1],
        [1, 0, 0, 0, 1, 0, 0, 0, 1],
        [1, 1, 1, 1, 1, 1, 1, 1, 1],
        [1, 0, 0, 0, 1, 4, 0, 0, 1],
        [1, 0, 0, 0, 1, 0, 0, 0, 1],
        [1, 0, 0, 2, 1, 0, 0, 0, 1],
        [1, 1, 1, 1, 1, 1, 1, 1, 1]
    ],
    "agent_start_position": [1, 1],
    "agent_start_size": 1,
    "boxes_start_positions": [
        [7, 2]
    ],
    "movements_limit": 15
}
