{
    "map": [
        [1, 1, 1, 1, 1, 1, 1, 1, 1],
        [1, 0, 0, 0, 0, 0, 0, 0, 1],
        [1, 0, 0, 0, 0, 0, 3, 0, 1],
        [1, 0, 0, 0, 0, 0, 0, 0, 1],
        [1, 1, 0, 1, 1, 1, 1, 1, 1],
        [1, 0, 0, 0, 0, 0, 0, 2, 1],
        [1, 0, 0, 0, 0, 0, 0, 0, 1],
        [1, 0, 0, 0, 0, 0, 0, 0, 1],
        [1, 1, 1, 1, 1, 1, 1, 1, 1]
    ],
    "agent_start_position": [1, 1],
    "agent_start_size": 2,
    "boxes_start_positions": [
        [5, 5]
    ],
    "movements_limit": 15
}
