{
    "map": [
        [1, 1, 1, 1, 1, 1, 1, 1, 1],
        [1, 3, 0, 0, 0, 0, 0, 0, 1],
        [1, 0, 0, 0, 0, 0, 0, 0, 1],
        [1, 0, 0, 0, 0, 0, 0, 0, 1],
        [1, 1, 1, 1, 0, 1, 1, 1, 1],
        [1, 0, 0, 0, 0, 0, 0, 0, 1],
        [1, 0, 0, 0, 0, 0, 0, 0, 1],
        [1, 0, 0, 2, 0, 2, 0, 0, 1],
        [1, 1, 1, 1, 1, 1, 1, 1, 1]
    ],
    "agent_start_position": [1, 6],
    "agent_start_size": 2,
    "boxes_start_positions": [
        [4, 4],
        [7, 4]
    ],
    "movements_limit": 26
}
